%s An update is available=%s: Een update is beschikbaar.
Alert Message=Waarschuwingsbericht
anonymous=anoniem
Author=Auteur
Check For Updates=Zoek naar updates
Checking connectivity=Connectiviteit controleren
checking=controleren
Click here to install version %s=Hier drukken om versie %s te installeren
Delete Plugin=Plug-in Opruimen
DOWNGRADE TO VERSION=DOWNGRADEN NAAR VERSIE
Enter URL of remote plugin file or local plugin file=Voer de URL in van een plug-inbestand of selecteer een lokaal plug-inbestand
ERROR=FOUT
I have read the release notes=Ik heb de uitgave-notities gelezen
Install Plugin=Plug-in Installeren
Install=Installeren
install=installeren
Installed Plugins=Geïnstalleerde plug-ins
Installing Update=Bezig met installeren van update
need check=check nodig
Next=Beta
No plugins installed=Geen plug-ins geïnstalleerd
No release notes available=Geen uitgave-opmerkingen beschikbaar
No response, aborting=Geen antwoord, afgebroken
Plugin File Install Errors=Plug-inbestand Installatiefout
Plugin File=plug-inbestand
Plugin History=Plug-in Geschiedenis
Plugin Update Check=Plug-in Update Controle
Plugin=plug-in
Release Notes=Uitgifte notities
Remove Plugin=Plug-in Verwijderen
Remove Selected Plugins=geselecteerde plug-ins verwijderen
remove=verwijderen
Select local plugin file=Selecteer lokale plug-inbestand
Stable=Stabiel
STALE=OUD
Support Thread=Hulppagina
Uninstall=Deïnstalleer
Update All Plugins=Update alle plugins
Update Incompatible=Update incompatibel
Update Plugin=Plug-in Updaten
Upgrade=Upgraden
View Release Notes=Bekijk uitgifte notities

; Note: April 21, 2025 - 1 missing translations
cannot check=
