Add Share=Gedeelde Map Toevoegen
All files encrypted=Alle bestanden zijn versleuteld
All files protected=Alle bestanden zijn beschermd
All files unprotected=Alle bestanden zijn onbeschermd
Allocation method=Toewijzingsmethode
Array must be Started to view Shares=De array moet **Gestart** zijn om gedeelde mappen te zien
Automatically split any directory as required=Verdeel automatisch elke folder zoals nodig
Automatically split only the top five directory levels as required=Verdeel automatisch enkel de vijf hoogste mapniveaus zoals nodig
Automatically split only the top four directory levels as required=Verdeel automatisch enkel de vier hoogste mapniveaus zoals nodig
Automatically split only the top level directory as required=Verdeel automatisch enkel het hoogste mapniveau zoals nodig
Automatically split only the top three directory levels as required=Verdeel automatisch enkel de drie hoogste mapniveaus zoals nodig
Automatically split only the top two directory levels as required=Verdeel automatisch enkel de twee hoogste mapniveaus zoals nodig
Clean Up=Opruimen
CLEAN UP=OPRUIMEN
Comments=Beschrijving
Compute All=Alles Berekenen
Compute=Berekenen
Disk Shares=Gedeelde Schijfmappen
Do not use pool names=Gebruik geen groepnamen
Do not use reserved names=Gebruik geen gereserveerde namen
Enable Copy-on-write=Gebruik Copy-on-write
Enter a name for the share=Voer een gedeelde mapnaam in
Excluded disks=Uitgesloten schijven
Exclusive access=Exclusieve toegang
Export=Exporteren
Fill-up=Opvullen
Free=Beschikbaar
has been deleted=is verwijderd
HDD=HDD
High-water=Hoog water
Included disks=Aangesloten schijven
Invalid Characters=Ongeldige karakters
Invalid share name=Ongeldige gedeelde mapnaam
Manual do not automatically split directories=Handmatig: geen automatische verdeling
Minimum free space=Minimum vrije ruimte
Missing share name=Ontbrekende gedeelde mapnaam
Most-free=Meest vrij
Mover action=Mover actie
Mover takes no action=Mover onderneemt geen actie
Mover transfers files from array to cache=Mover verplaatst bestanden van de array opslag naar de cache opslag
Mover transfers files from cache to array=Mover verplaatst bestanden van de groep opslag naar de array opslag
Mover transfers files from Primary storage to Secondary storage=Mover verplaatst bestanden van Primaire opslag naar secundaire opslag
Mover transfers files from Secondary storage to Primary storage=Mover verplaatst bestanden van Secundaire opslag naar primaire opslag
next user share=volgende gedeelde gebruikersmap
No unused share configurations present=Geen ongebruikte gedeelde mappenconfiguraties aanwezig
Not used=Niet gebruikt
Only=Enkel
Prefer=Voorkeur
previous user share=vorige gedeelde gebruikersmap
Primary storage %s=Primaire opslag %s
Primary storage for new files and folders=Primaire opslag (voor nieuwe bestanden en mappen)
Primary storage to Secondary storage=Primaire opslag naar secundaire opslag
Read=Lezen
Recompute=Herberekenen
Remove unused share configurations=Verwijder ongebruikte gedeelde mappenconfiguraties
Removed share configurations=Gedeelde mappenconfiguraties verwijderd
Rule=Regel
Secondary storage to Primary storage=Secundaire opslag naar primaire opslag
Secondary storage=Secundaire opslag
Select cache pool=Selecteer groep opslag
Set when adding new share only=Wordt enkel gebruikt bij aanmaken van een nieuwe gedeelde map
Share contains data=Gedeelde map bevat gegevens
Share is empty=Gedeelde map is leeg
Share is outside the list of designated disks=Gedeelde map is buiten de lijst van toegekende schijven
Share name contains invalid characters for ZFS use=Gedeelde map bevat ongeldige karakters voor ZFS gebruik
Share Settings=Gedeelde Mapinstellingen
Share status=Gedeelde mapstatus
Size=Grootte
Some or all files unencrypted=Sommige of alle bestanden zijn onversleuteld
Some or all files unprotected=Sommige of alle bestanden zijn onbeschermd
Split level=Verdeelniveau
SSD=SSD
Storage=Opslag
There are no exportable disk shares=Er zijn geen exporteerbare gedeelde schijfmappen
There are no exportable user shares=Er zijn geen exporteerbare gedeelde gebruikersmappen
Time Machine volume size limit=Time Machine volume grootte
Unknown encryption state=Onbekende versleuteltoestand
Use cache pool for new filesdirectories=Gebruik cache opslag (voor nieuwe bestanden/folders)
User Shares=Gedeelde Gebruikersmappen
Write=Schrijven
You cannot use the following within share names=De volgende karakters kunnen niet worden gebruikt binnen de gedeelde mapnamen

; Note: December 28, 2024 - 11 missing translations
Free Space will be calculated=
is missing=
it references storage that does not exist=
It references storage that does not exist=
Share is empty and is safe to delete=
Share must be empty to be deleted=
There are no mountable array or pool disks - cannot add shares=
This share is invalid=
Unknown cache usage=
Unknown protection status=
Warning: Configured Pool=
