Cancel=Annuleren

; My PSAs / banners
Happy New Year=Gelukkig nieuwjaar
Happy Holidays from Andrew, Tracey, and family=Prettige vakantie van Andrew, Tracey en familie
Please Enjoy Responsibly=Gelieve verantwoord genieten
Popup Blocked CA requires popups to be enabled under certain circumstances You must white list your server within your browser to allow popups=Pop-up geblokkeerd CA gebruikt pop-ups voor bepaalde doeleinden. De server moet worden white-listed in de browser om pop-ups toe te staan
Docker Service Not Enabled - Only Plugins Available To Be Installed Or Managed=Dockerdienst niet ingeschakeld - Alleen plug-ins zijn beschikbaar voor installatie of beheer
Docker system failed to start - Only Plugins Available To Be Installed Or Managed=Docker-systeem kan niet worden gestart - Alleen plug-ins kunnen worden geïnstalleerd of beheerd
Array not started - Only Plugins Available To Be Installed Or Managed=Array niet gestart - Alleen plug-ins kunnen worden geïnstalleerd of beheerd
Community Applications works best when cookies are enabled in your browser Certain features may not be available=Community Applications werkt het beste wanneer cookies zijn toegestaan in de browser. Sommige kenmerken zijn mogelijk niet beschikbaar
Backup Server Active Some icons may not appear, and plugin installations may be affected=Backup server actief Sommige ikonen verschijnen mogelijk niet, en plug-in installaties zijn mogelijk verhinderd
Debugging enabled This significantly increases the memory used by your browser=Debug ingeschakeld. Dit verhoogt aanzienlijk het geheugengebruik van de browser
Browser translation detected Display issues may result=Browservertaling gedetecteerd. Weergaveproblemen kunnen het gevolg zijn

; Sorting Options
Sort By=Sorteer op
Name Ascending=Naam oplopend
Name Descending=Naam aflopend
Downloads=Downloads
Date Added=Datum toegevoegd
Number Of Apps=Aantal apps
; Initial disclaimer translations
Disclaimer=Disclaimer
All applications listed here are 3rd party additions to Unraid Neither the authors of Community Applications nor Limetech make any warranty as to the suitability of any application listed here=Alle hier vermelde toepassingen zijn toevoegingen op Unraid van derde partijen. Noch de auteurs van Community Applications, noch Limetech geven enige garantie met betrekking tot de geschiktheid van de hier vermelde toepassingen
Every attempt is made to ensure that only safe and compatible applications are present=Alles is eraan gedaan om ervoor te zorgen dat veilige en compatibele toepassingen aanwezig zijn
Application Policy=Toepassingsbeleid
I Understand=Ik begrijp het
Installations of apps disabled You must accept the warning to be able to install applications=Installatie van apps uitgeschakeld. De waarschuwing om het installeren van toepassingen toe te staan, moet worden geaccepteerd
Click here=Hier drukken
%s Results Per Page=%s resultaten per pagina
Results Per Page: %s=Resultaten per pagina: %s

; Plugin Disclaimer
Community Applications contains both docker containers and plugin applications Plugins are designed for OS enhancements, and run with full privileges on your system and are clearly identified within CA=Community Applications bevatten zowel docker containers als plug-ins. Plug-ins zijn ontworpen voor besturingssysteem toevoegingen, en draaien met volledige rechten op het systeem en zijn duidelijk gemarkeerd binnen CA
Plugin Note=Plug-in notitie

; Multi Install
Install Plugin Applications=Plug-in toepassingen installeren
Select all on page=Selecteer alles op pagina
Install Application=Applicatie installeren
Install Applications=Applicaties installeren
Update Applications=Applicaties bijwerken
Are you sure you want to update %s applications=Weet je zeker dat je %s applicaties wilt bijwerken
Are you sure you want to install %s docker and %s plugin applications=Weet je zeker om %1$s docker en %2$s plug-in applicatie(s) te installeren

; Searches
Search=Zoeken
Click Here To Get More Results From DockerHub=Druk hier voor meer resultaten van DockerHub
No Matching Applications Found=Geen passende toepassingen gevonden

; Repository Related
%s removed as favourite repository=%s verwijderd als favoriete repository
%s set as favourite repository=%s ingesteld als favoriete repository
Click to remove favourite repository=Klik om favoriete repository te verwijderen
Click to set %s as favourite repository=Klik om %s in te stellen als favoriete repository
Search for apps in repository=Zoeken naar apps in de repository
No description present=Geen beschrijving aanwezig
Go to the forum page=Ga naar de forumpagina
Go to the webpage=Ga naar de webpagina
Go to reddit=Ga naar reddit
Go to facebook=Ga naar facebook
Go to discord=ga naar discord
Go to forum profile=Ga naar forumprofiel
Show Profile=Profiel tonen
SHOW MORE=MEER TONEN
SHOW LESS=MINDER TONEN
Read more=Lees meer
Total Applications=Totaal aantal toepassingen
Total Known Downloads=Totaal aantal bekende downloads
Total Docker Applications=Totaal aantal Docker toepassingen
Total Plugin Applications=Totaal aantal Plugin toepassingen
Total Languages=Totaal aantal vertalingen
Average Downloads Per App=Gemiddeld downloads per App
Web Page=Webpagina
Forum=Forum
Forum Profile=Forumprofiel
Profile=Profiel
Facebook=Facebook
Reddit=Reddit
Twitter=Twitter
Discord=Discord
Search Apps=Apps zoeken
Registry=Registry
Details=Details
Added=Toegevoegd
; Install Plugin title of openbox
Install Plugin=Plug-in installeren
Update Plugin=Plug-in bijwerken

Requirements not met=Eisen niet voldaan
The requirements for this upgrade have not been met on your system=Er is niet voldaan aan de vereisten voor deze upgrade van het systeem

BACK=TERUG

; Remove App from previously installed
Delete Template=Sjabloon verwijderen
Yes, delete it=Ja, verwijderen

; Uninstall popup
Uninstall Application=Toepassing verwijderen
Yes uninstall it=Ja, deïnstalleren

; Remove Private Application
Remove Private Application=Private toepassing verwijderen
Yes, remove it=Ja, verwijderen

; App Pinning
Click to pin this application=Druk om deze toepassing vast te zetten
Click to unpin this application=Druk om deze toepassing los te maken
Pin App=App vastzetten
Unpin App=App loskoppelen

; Branch installations
Choose A Branch To Install=Kies een tak om te installeren

; Multiple application installs
; no apps selected
Install Selected Applications=Geselecteerde toepassingen installeren

Yes, install it=Ja, installeren

; Multi-install popup
Yes, install them=Ja, installeren
Cookies not enabled Plugins must be separately installed from docker applications=Cookies niet ingeschakeld. Plug-ins moeten apart van docker toepassingen worden geïnstalleerd
Docker applications will be installed utilizing the most recently saved template with no user input on your part=Docker toepassingen worden geïnstalleerd gebruikmakend van het meest recent opgeslagen sjabloon zonder verdere gebruikersinvoer
Updating Support Links=Ondersteuningsverwijzingen bijwerken
Downloading docker icons=Docker-pictogrammen downloaden
Finished Installing If the DONE button did not appear, then you will need to click the red X in the top right corner=Klaar met installeren Als de KLAAR toets niet verschijnt, dan dient op de rode X rechtsboven te worden gedrukt

; error messages
An error occurred Could not find any %s Apps=Een fout is opgetreden. Kon geen enkele %s Apps vinden
Download of appfeed failed=Downloaden van de appfeed is mislukt
; the %s here refers to a function being called
Something really went wrong here=Iets verschrikkelijk fout hier
Post the ENTIRE contents of this message in the Community Applications Support Thread=Post de GEHELE inhoud van dit bericht in de hulplijn voor Community Applications
Unknown error happened Please post a screenshot in the support thread of the Statistics screen=Onbekende fout opgetreden. Gelieve een screenshot te plaatsen in de hulplijn van het Statistiekenscherm
This plugin has a duplicated name from another plugin %s This will impact your ability to install both plugins simultaneously=Deze plug-in heeft een dubbele naam met een andere plug-in %s. Dit heeft invloed op beide plug-ins bij tegelijkertijd installeren
You have been logged out=U bent uitgelogd
Fatal Flash Drive Error=Fatale Flash Drive-fout
This usually means your flash drive is corrupted or has dropped offline The rest of the Unraid GUI will also be affected Post a new thread in the Unraid forums if this error continues=Dit betekent meestal dat uw flashstation beschadigd is of offline is gevallen. De rest van de Unraid GUI wordt ook beïnvloed. Plaats een nieuw bericht in de Unraid-forums als deze fout zich blijft voordoen
Fatal Docker Image Error=Fatale Docker-image fout
Your docker image or folder is either read-only or completely full Issues will result because of this You should create a new post in the Unraid forums and include your diagnostics=De docker-image of -map is ofwel alleen-lezen of volledig vol. Hierdoor zullen problemen het gevolg zijn. U moet een nieuw bericht maken in de Unraid-forums en uw diagnose toevoegen
This template is set up to use a custom network You may have to adjust the network or IP address etc to match your system=Deze sjabloon is ingesteld om een aangepast netwerk te gebruiken. Mogelijk moet u het netwerk of IP-adres enz. aanpassen aan uw systeem
One or more ports used by this application are already in use by another service or app running on your server You will need to adjust the host ports accordingly on the template=Een of meerdere poorted gebruikt door deze applicatie zijn al in gebuik door een andere service of app die op uw server wordt uitgevoerd. U moet de hostpoorten aanpassen aan de hand van de template

; CA Sections Keep the length reasonable
Home=Thuis
Installed Apps=Geïnstalleerde Apps
Previous Apps=Vorige Apps
Pinned Apps=Vastgezette Apps
Favourite Repo=Favoriete Repo
Action Centre=Actiecentrum
Recently Added=Recent toegevoegd
Random Apps=Willekeurige Apps
Top New Installs=Top nieuwe installaties
Top Trending Apps=Populairste trending-apps
Spotlight Apps=Spotlicht-apps
All Apps=Alle Apps
Statistics=Statistieken
Credits=Credits
Support=Ondersteuning
VERSION=VERSIE
Change Log=Wijzigingen
Debugging=Debuggen

; Credits
Development=Ontwikkeling
Additional Contributions=Extra bijdragen
GUI Layout Design=GUI layout ontwerp
Application Feed=Toepassingsfeed
Additional Testing=Extra testen
Moderation=Moderatie
Additional Libraries=Extra bibliotheken
Copyright=Auteursrechten
Translation=Vertaling

; Statistics page

unknown=onbekend
Last Change To Application Feed=Laatste verandering aan toepassingsfeed
Docker Applications=Docker toepassingen
Plugin Applications=Plugin toepassingen
Templates=Sjablonen
Official Containers=Officiële containers
Repositories=Repositories
Private Docker Applications=Private Docker-toepassingen
Invalid Templates=Ongeldige sjablonen
Template Errors=Sjabloon fouten
Blacklisted Apps=Apps op zwarte lijst
Incompatible Applications=Incompatibele toepassingen
Deprecated Applications=Verouderde toepassingen
Moderation Entries=Moderatie-items
Primary Server=Primaire server
Backup Server=Back-up server
Installs not allowed from this page=nstallaties niet toegestaan vanaf deze pagina

; Statistics Popup
No invalid templates found=Geen geldige sjablonen gevonden
These templates are invalid and the application they are referring to is unknown=Deze sjablonen zijn ongeldig en de toepassing waar naar ze verwijzen is onbekend
No templates were automatically fixed=Geen sjablonen werden automatisch hersteld
All of these errors found have been fixed automatically=Al deze gevonden fouten zijn automatisch hersteld
Note that many of these errors can be avoided by following the directions=Letop veel van dez fouten kunnen worden vermeden door de richtlijnen te volgen
HERE=HIER
The following plugins have duplicated filenames and are not able to be installed simultaneously=De volgende plug-ins hebben dubbele bestandsnamen en kunnen niet gelijktijdig worden geïnstalleerd
The following docker applications refer to the same docker repository but may have subtle changes in the template to warrant this=De volgende docker toepassingen verwijzen naar dezelfde docker repository maar kunnen subtiele verschillen in het sjabloon hebben
If any of these entries are incorrect then contact the moderators of CA to discuss=Als een van deze vermeldingen onjuist is, neem dan contact op met de moderators van CA om dit te bespreken
Global Repository Comments=Algemene repository commentaar
Applied to all applications=(Toegepast op alle toepassingen)
Individual Application Moderation=Individuele moderatie van toepassingen

; Misc
Community Applications Changelog=Community Applications wijzigingen

Each month we highlight some of the amazing work from our community=Elke maand belichten we een aantal van het geweldige werk van onze community
Check out these newly added applications from our awesome community=Bekijk deze nieuw toegevoegde toepassingen van onze geweldige community
Check out these up and coming apps=Bekijk deze opkomende apps
These apps have the highest percentage of new installs=Deze apps hebben het hoogste percentage nieuwe installaties
An assortment of randomly chosen apps=Een assortiment van willekeurig gekozen apps

; Categories try not to be excessively long This is displayed on the left of CA screen

Backup=Back-up
Cloud=Cloud
Crypto Currency=Cryptovaluta
Downloaders=Downloaders
Drivers=Stuurprogramma's
Game Servers=Spel Servers
Home Automation=Domotica
Media Applications=Media-toepassingen
Books=Boeken
Music=Muziek
Photos=Foto's
Video=Video
Other=Overige
Media Servers=Mediaservers
Network Services=Netwerkdiensten
DNS=DNS
FTP=FTP
Management=Management
Messenger=Berichten
Proxy=Proxy
VOIP=VOIP
VPN=VPN
Web=Web
Privacy=Privacy
Productivity=Productiviteit
Security=Beveiliging
Spotlight=Uitgelicht
Tools Utilities=Gereedschap / Hulpprogramma's
System=Systeem
Themes=Themas
Utilities=Hulpprogramma's
Private Apps=Privaat Apps
Uncategorized=Ongesorteerd

; Categories displayed within a popup or on the card.  Where an entry exists after the "=" it is not translated, but rather how it should look
GameServers=Spelletjes
HomeAutomation=Domotica
MediaApp=MediaApp
MediaAppBooks=MediaApp:Boeken
MediaAppMusic=MediaApp:Muziek
MediaAppPhotos=MediaApp:Fotos
MediaAppVideo=MediaApp:Video
MediaAppOther=MediaApp:Overige
MediaServer=MediaServer
MediaServerBooks=MediaServer:Boeken
MediaServerMusic=MediaServer:Muziek
MediaServerPhotos=MediaServer:Fotos
MediaServerOther=MediaServer:Overige
Network=Netwerk
NetworkDNS=Netwerk:DNS
NetworkFTP=Netwerk:FTP
NetworkManagement=Netwerk:Management
NetworkProxy=Netwerk:Proxy
NetworkVOIP=Netwerk:VOIP
NetworkVPN=Netwerk:VPN
NetworkPrivacy=Network:Privacy
NetworkWeb=Netwerk:Web
NetworkOther=Netwerk:Overige
ToolsSystem=Gereedschap:Systeem
ToolsThemes=Gereedschap:Themas
ToolsUtilities=Gereedschap:Hulpprogramma's
OtherUncategorized=Overige:Ongesorteerd
and %s more=en %s meer

; App Popup Related
This application template has been blacklisted=Deze toepassingsjabloon staat op de zwarte lijst
This application template has been deprecated=Deze toepassingsjabloon is verouderd
This application has additional requirements=Deze toepassing heeft aanvullende vereisten
Additional Requirements=Aanvullende vereisten
Donate To Author=Donatie aan de auteur
Donate To Maintainer=Donatie aan de onderhouder
CLOSE=SLUITEN
Author=Auteur
Maintainer=Onderhouder
DockerHub=DockerHub
Application Template=Toepassingsjabloon
DockerHub Stars=DockerHub sterren
Added to CA=Toevoegd aan CA
Date Updated=Datum van bijwerken
Current Version=Huidige versie
Min OS=Minimale OS
Max OS=Maximale OS
Total Downloads=Totaal downloads
Licence=Licentie
Ranked #%s=Geplaatst #%s
; as in Trending up or down arrow
Trending %s=Populair %s
; as in As of some date
As of %s=(Vanaf %s)
Play Video=Video afspelen
Play Video %s=Speel video %s af
This application is not compatible with your version of Unraid=Deze toepassing is niet compatibel met deze versie van Unraid
Another browser tab or device has updated the displayed templates Some actions are not available=Een andere browser pagina of apparaat heeft de getoonde sjablonen bijgewerkt. Sommige acties zijn niet beschikbaar
WebUI=WebUI
Reinstall=Herinstalleren
Reinstall From Previous Apps=Herinstalleren vanuit vorige apps
Install=Installeren
Uninstall=Verwijderen
Project=Project
Read Me First=Lees mij eerst
Install Using The Templates Default Tag=Installeer gebruikmakend van de sjabloon's Standaard tag
Moderator Comments=Moderator Commentaar:
Note not all authors keep up to date on change logs=Letop niet alle auteurs houden een wijzigingslog bij
Note not all maintainers keep up to date on change logs=Letop niet alle onderhouders houden een wijzigingslog bij
Last Update=Laatste Update
Note All statistics are only gathered every 30 days=Letop: alle statistieken worden enkel elke 30 dagen verzameld
;the following if using a space you MUST use nbsp but keep it down to one word if at all possible
Donate=Doneren
Currently Installed Version=Huidige geïnstalleerde versie:
Install The Update=Update installeren
; as in you have the latest version already installed
Latest Version=Laatste versie
Multi Language Support=Ondersteuning voor meerdere talen
Support Forum=Ondersteuningsforum
; as in more than 100000
More than %s=Meer dan %s
Remove from Previous Apps=Verwijderen uit vorige apps
Remove=Verwijderen
See All Apps=Zie alle Apps
Favourite=Favoriet
Application Type=Toepassingstype

; Graphs
Trend Per Month=Trend per maand
Downloads Per Month=Downloads per maand

; Multi install script
Installing docker applications %s=Installeren van docker toepassingen
Starting %s=Start %s
%s failed to start You should install it by itself to fix the errors=%s niet gestart Je moet deze zelf installeren om fouten te herstellen
Setting installed applications to autostart=Instelling geïnstalleerde toepassingen voor autostart
Docker Application Installation finished=Docker-toepassing installatie klaar

; Application Cards
Actions=Acties
This application is a driver plugin=Deze toepassing is een stuurprogramma (plugin)
This is a language pack=Dit is een taalpakket
This application is a docker container=Deze toepassing is een docker-container
This application is a plugin=Deze toepassing is een plug-in
This is a spotlight application=Dit is een spotlicht-toepassing
This is your favourite repository=Dit is je favoriete repository
This application is from your favourite repository=Deze toepassing komt uit je favoriete repository
This application is pinned for later viewing=Deze toepassing is vastgezet om later te bekijken
Private Application=Private toepassing
Remove Application From List=Toepassing verwijderen van lijst
Check off to select multiple reinstalls=Vink aan om meerdere herinstallaties te selecteren
Go to the plugin settings=Ga naar de plug-in instellingen
Click to reinstall the application using default values=Druk om de toepassing te herinstalleren met standaard waarden
Click to edit the application values=Druk om de toepassing waarden te bewerken
Click to reinstall=Druk om te herinstalleren
Click to install=Druk om te installeren
Click to go to the WebUI=Druk hier om naar de WebUI te gaan
This application template has been deprecated=Deze toepassingsjabloon is verouderd
This application template has been blacklisted=Deze toepassingsjabloon staat op de zwarte lijst
Click info to see the notes regarding this application=Klik op info om de opmerkingen over deze toepassing te zien
This application has additional requirements=Deze toepassing heeft aanvullende vereisten
BETA=BETA
INSTALLED=GEÏNSTALLEERD
OFFICIAL=OFFICIEEL
UPDATED=BIJGEWERKT
This is an official container=Dit is een officiële container
Digitally Signed=Digitaal ondertekend
This container is digitally signed=Deze container is digitaal ondertekend
Docker Hub=Dockerhub
NOTE You must visit the dockerHub page to gather the information required to install correctly=LETOP Je moet de dockerHub-pagina bezoeken om de informatie te verzamelen die nodig is om correct te installeren
Show CA templates=CA sjablonen tonen
Deprecated=Verouderd
Incompatible=Incompatibel
Blacklisted=Op de zwarte lijst gezet
Template Exists=Sjabloon Bestaat
Template already exists in Apps=Sjabloon bestaat al in Apps
; eg: LinuxServer Repository
%s Repository=%s repository
; eg: Squid's Repository
%s's Repository=%ss repository

Info=Info
Attention=Attentie
Repository=Repository
Why we picked it=Waarom we het hebben gekozen
Application Spotlight %s=Toepassing spotlicht %s
Unraid Staff=Unraid-personeel

; Page Navigation
Displaying %s - %s of %s=Weergeven %1$s - %2$s (van %3$s)

Updating Content=Inhoud bijwerken
Language=Taal
Switch to this language=Schakel over naar deze taal
Country Code=Landcode
Install Language Pack=Taalpakket installeren
Remove Language Pack=Taalpakket verwijderen
Update Language Pack=Taalpakket bijwerken
Installed Version=Geïnstalleerde versie
A note about translations=Opmerking over vertalingen
Click here to view the language changelog=Hier drukken om het taalwijzigingslogboek
View Missing Translations=Toon ontbrekende translaties

; Update Checks
Check For Updates=Zoek naar updates
Check for updates already running=Zoeken naar updates loopt al
Checking for docker container updates=Zoek naar docker container updates
Checking for plugin updates=Zoeken naar plug-in updates
Checking for language updates=Zoeken naar taal updates
Checking %s=Zoeken %s

; dockerHub conversions
Determine configuration=Configuratie bepalen
Would you like CA to attempt to determine any applicable paths, ports, and variables for the template This will entail performing a test installation of the container It will be automatically deleted after processing The container will not be started=Wilt u dat CA probeert om toepasselijke paden, poorten en variabelen voor de sjabloon te bepalen? Hiervoor wordt een proefinstallatie van de container uitgevoerd. Na verwerking wordt het automatisch verwijderd. De container wordt niet gestart.
An error occurred - Could not determine configuration=Er is een fout opgetreden - kon configuratie niet bepalen
; WebGui
Click Install to download and install the Community Applications plugin=Klik op **Installeren** om de **Community Applications** plug-in te downloaden en te installeren


; Note: April 21, 2025 - 25 missing translations
Action Centre Enabled=
Deprecated OS version No further updates to Community Applications will be issued for this OS version=
Update Application=
The sidebar for the app click info will list the details=The sidebar for the app (click info) will list the details
This template is set up to run as Privileged This is a possible security risk and usually does not need to be enabled Note that some applications require privileged in order to operate correctly=
Not Enough Memory=
Community Applications and Unraid OS have a minimum required installed memory of 4G CA cannot run without those mimimums being met=
Run Anyways=
Memory Requirements not met Problems may result=
Installation already in progress=
Another plugin installation or update is already in progress and this one cannot start Wait until the current installation or update is completed and try again=
Clear Flag=
%s is incompatible with your OS version Please update the OS to proceed=
%s is incompatible with your OS version Either uninstall %s or update the OS=
Browser failed to communicate with Unraid Server=
For unknown reasons, your browser was unable to communicate with Community Applications running on your server=
Additional information may be within Tools, PHPSettings - View Log=
Attempt to Fix Via Reload Page=
External Link=
Clicking OK will take you to a 3rd party website not associated with Limetech=
Featured Applications=
MediaServerVideo=MediaServer:Video
Popularity=
Install another instance=
Pending=
